1,0,0|0,2,0|1,0,0|0,0,0|0,0,0
8,0,0|5,0,3|8,0,0|5,0,0|0,3,3
0,0,0|2,0,0|0,1,3|2,0,2|0,0,0
0,0,0|3,0,1|4,0,0|1,0,0|0,0,0
0,2,2|0,0,0|0,0,0|8,0,0|4,0,0