1,2,3|0,3,2|0,0,3|0,0,1|0,0,0|0,0,2|0,0,3
8,0,0|4,2,0|0,0,0|0,0,0|0,3,0|0,0,1|0,0,0
7,0,0|4,2,0|0,0,0|1,1,0|0,0,0|0,0,0|0,0,1
2,0,2|7,0,3|4,3,0|8,0,0|4,0,3|0,3,2|0,0,0
3,0,0|9,0,0|4,0,0|3,0,2|4,0,0|0,0,3|0,3,0